##########################
#@#......#...............#
#%#......#.#############.#
#.#####..#.#...........#.#
#.....#..#.#.#######...#.#
#####.#..#.#.#.....#...#.#
#...#.#..#!#.#.###.#...#.#
#...#.########.#.#.#...#.#
#...#....%.....#.#.#...#.#
#...#%......####.#.#...#.#
#...#########....#.#...#.#
#...##############.#...#.#
#................#.#####.#
#................#.......#
##########################