&&&&&&&&&&&&&&&&&&&&&&&&&&
&^^^^^^^^5&^^^^^^^^5&^^^À&
&5^^^&5^^^&5^^^&5^^^&5^^^&
&^^^5&^^^5&^^^5&^^^5&^^^5&
&5^^^&5^^^&5^^^&5^^^&5^^^&
&^^^5&^^^5&^^^5&^^^5&^^^5&
&5^^^&5^^^&5^^^&5^^^&5^^^&
&^^^5&^^^5&^^:5&^^^5&^^^5&
&5^^^&5^^^&5^^^&5^^^&5^^^&
&^^^5&^^^5&^^^5&^^^5&^^^5&
&5^:^&5^^^&5^^^&5^:^&5^^^&
&^^^5&^^^5&^^^5&^^^5&^^^5&
&5^^^&5^^^&5^^^&5^^^&5^^^&
&+^^^&^^^^^^^^5&^^^:^:^^5&
&&&&&&&&&&&&&&&&&&&&&&&&&&