##########################
#@#......#...............#
#.#......#.#############.#
#.#####..#.#...........#.#
#%...%#..#.#.#######...#.#
#####.#..#.#.#.....#...#.#
#...#.#..#!#.#.###.#...#.#
#...#.########.#.#.#...#.#
#...#..%.%.....#.#.#...#.#
#...#%.....%####.#.#...#.#
#...#########....#.#...#.#
#...##############.#...#.#
#................#.#####.#
#................#.......#
##########################