##########################
#@#......#...............#
#.#......#.#############.#
#.#####..#.#...........#.#
#.....#..#.#.#######...#.#
#####.#..#.#.#.....#...#.#
#...#.#..#!#.#.###.#...#.#
#...#.########.#.#.#...#.#
#...#....%.....#.#.#...#.#
#...#..%....####.#.#...#.#
#...#########....#.#...#.#
#..###############.#...#.#
#................#.#####.#
#................#.......#
##########################