##########################
#........................#
#.##########.###########.#
#.#....................#.#
#.#..################..#.#
#.#..#..............#..#.#
#.#..#..............#..#.#
#.#..#......!.......#..#.#
#.#....................#.#
#.#..#..............#..#.#
#.#..################..#.#
#.#....................#.#
#.##########.###########.#
#.@......................#
##########################