##########################
#%.......................#
#.##########.###########.#
#.#...................%#.#
#*#..################..#.#
#.#..#.............%#..#.#
#*#..#..............#..#.#
#.#..#......!.......#..#.#
#.#....................#.#
#*#..#%.............#..#.#
#.#..################..#.#
#.#%...................#.#
#*##########.###########.#
#.@....*...o............%#
##########################