##########################
#%.....*......*......*...#
#.##########.###########.#
#.#.%.....*......*....%#.#
#*#..################..#.#
#.#..#.%..o.....%..%#..#.#
#*#..#...*******....#..#.#
#.#.*#...*..!..*....#..#.#
#.#......*******.......#.#
#*#*.#%.%...*.o..%%.#..#.#
#.#..################..#.#
#.#%.......*.....*...%.#.#
#*##########.###########.#
#.@....*.........*......%#
##########################