&5^^^:^^^^^^^?&&&&&&&&&&&&
&^&&&^&&&&&&&&&&&&&&&&&&&&
&^&5^^^^^^^^^^^^^^^^^^&::^
&^&&&&&&&&&&&&^&&&&^&&&:^:
&^^^^^&&^^^^:^^&::&^&:^^^^
&^&^&^^^^:^&&&&&&&&^&&&&&x
&^^^&^&&&&&&&&&&^^^^^^^^&^
&^&&&^&^^^^^:^^5&&&&&&&^&&
&^&^^^&^&&&^&&&^^^^^^^&^^&
&^&&&&&^&&&&&&&&&&&&&^&&^&
&:&^^^^^&~&5^^:^^&5^^^^^^&
&:&^&&&&&^&^^^^^5&&&&^&&^&
&:&^&:x:&^^^&&&&&&&&&^^^5&
&5&À&^^5&^&^^^^^^^^^^^^5&&
&&&&&&&&&&&&&&&&&&&&&&&&&&